.
these professional calibrators are licensed to use controlcal .
this post will be updated .
by state ?
see post # 2 owner 's professional post calibration reports and reviews edit : i added the isfccc tag which shows which professionals can / will also enable the pioneer elite 's isfccc interface and for which generation ( [ 8g ] and / or [ 9g ] and / or [ m ] for 9g elite signature monitor isfccc support ) .
have a krp - 500m or krp - 600m that you want patched and / or professionally calibrated ?
see this list for professionals that can .
the list below is not for krp - 500m or krp - 600m models david abrams at avical - isfccc [ 8g ] [ 9g ] [ m ] - national tours ( la metro based ) .
eliab alvarez de la campa at avical - isfccc [ 8g ] [ 9g ] [ m ] - national tours ( ny metro based ) .
kevin miller - isfccc [ 8g ] [ 9g ] [ m ] - serving the new york tri-state area : nyc , long island , southern ct , and central and northern new jersey .
tom huffman - isfccc [ 7g ] [ 8g ] [ 9g ] [ m ] - washington d.c. and maryland / virginia suburbs .
stephen cooper at digital video calibrations - isfccc [ 8g ] [ 9g ] [ m ] - jacksonville florida and the surrounding areas .
frank kondilis - isfccc [ 9g ] - scottsdale arizona ( only calibrating existing customers and their referrals ) .
gregg loewen at lion av - isfccc [ 8g ] [ 9g ] [ m ] - new england and eastern seaboard down to the greater dc area , florida , las vegas , los angeles , san diego and maritime canada .
michael chen at the laser video experience / lion av affiliate - isfccc [ 8g ] [ 9g ] [ m ] - tours - calgary & edmonton and central / southern alberta and the adjacent provinces .
michael hamilton at the real picture / lion av affiliate - isfccc [ 8g ] [ 9g ] [ m ] - scottsdale arizona based .
doug weil at clearly resolved / lion av affiliate - isfccc [ 8g ] [ 9g ] [ m ] - national tours ( covering ar , ga , il , in , ia , ks , ky , mi , mn , mo , nc , nd , oh , ok , sc , sd , tn , tx ) from st. louis .
david evans at 21st century calibrations inc. - isfccc [ 8g ] [ 9g ] - fairview oregon based and servicing all of oregon / washington and the boise idaho area .
chad billheimer at hdtvbychadb.com - isfccc [ 8g ] [ 9g ] [ m ] - ohio / virginia based - tours to texas , new york , minnesota , florida , chicago , baltimore and most areas in between .
zygmunt wojewoda at perfect home theater - isfccc [ 8g ] [ 9g ] [ m ] - serving new england ( chestnut hill massachusetts based ) .
ken whitcomb at calibrations , inc. - isfccc [ 8g ] [ 9g ] - indianapolis indiana based .
eric hedin at core control systems - isfccc [ 8g ] [ 9g ] - serving the new york greater capital region .
kevin mckee at home definition - isfccc [ 8g ] [ 9g ] - red bank new jersey based .
glenn zink at video calibration services - isfccc [ 8g ] [ 9g ] [ m ] - laguna niguel california based .
robert busch at busch home theater - isfccc [ 8g ] [ 9g ] [ m ] - national tours ( san francisco / bay area based ) .
glen carter at home theater calibration - isfccc [ 8g ] [ 9g ] [ m ] - serving southern california from whittier .
greta e colgan at beyond the studs - isfccc [ 8g ] [ 9g ] [ m ] - wilmington delaware based .
michael osadciw at the highest fidelity - isfccc [ 8g ] [ 9g ] [ m ] - serving southern ontario , quebec , new brunswick , yukon & northwest territories ( call 905-730-5996 ) .
william powell at alpha video systems - isfccc [ 8g ] [ 9g ] [ m ] - serving chattanooga tennessee ( call 423-698-8618 ) .
david voncannon at d & e associates - isfccc [ 8g ] [ 9g ] [ m ] - serving southern california , culver city based ( call 310-628-1170 ) .
richard stokes at finely tuned - isfccc [ 8g ] [ 9g ] [ m ] - serving vancouver bc canada .
lee gallagher at advanced audio visual - isfccc [ 8g ] [ 9g ] [ m ] - serving the entire state of arizona from phoenix .
frank kondrot at day 1 services - isfccc [ 8g ] [ 9g ] [ m ] - serving orange co. .
california from laguna hills .
scott schackel at beeswing audio video - isfccc [ 8g ] [ 9g ] [ m ] - serving northern california from redwood city .
helmut kaczmarek at finaltouch av - isfccc [ 8g ] [ 9g ] [ m ] - serving southern california , santa clarita based ( call 818-269-1427 ) .
milton krueger at audio video guys - isfccc [ 8g ] [ 9g ] [ m ] - serving houston texas .
doug blackburn at db theatrical - isfccc [ 8g ] [ 9g ] [ m ] - serving colorado and surrounding states from colorado springs .
branden pirot at home theatre projections - serving a 60 mile radius around dallas oregon ( call 503-949-6845 ) .
robert jones ( mr bob ) at image perfection - isfccc [ 8g ] [ 9g ] [ m ] - serving san fransicso california from san lorenzo .
barry vandenberg at orlando digital tv - isfccc [ 8g ] [ 9g ] [ m ] - serving central florida from orlando .
chris eberle at precision video - isfccc [ 8g ] [ 9g ] [ m ] - serving new york metro , westchester , hudson valley , albany , new jersey , connecticut and eastern pennsylvania .
mark kaye at avfusion - isfccc [ 8g ] [ 9g ] [ m ] - serving eastern ontario & western quebec .
gary mollura at custom audio video calibrations - isfccc [ 8g ] [ 9g ] [ m ] - serving upstate ny including binghamton , elmira , ithaca , utica , watertown , elmira , and auburn from syracuse , ny .
fred dietzel at enhanced audio & video - isfccc [ 8g ] [ 9g ] [ m ] - serving south central pennsylvania .
paul thorsen at experience home theatre - isfccc [ 8g ] [ 9g ] [ m ] - serving vancouver lowermainland , fraser valley , vancouver island , okanagan , sunshine coast and whistler bc canada .
shawn byrne at sound advice av calibration - isfccc [ 8g ] [ 9g ] [ m ] - serving kansas , missouri , oklahoma , nebraska , arkansas and iowa .
summit hdtv - isfccc [ 8g ] [ 9g ] [ m ] - serving the southeast michigan area , jackson , mi , lansing , mi and toledo , oh .
michael combs at definitive audio - isfccc [ 8g ] [ 9g ] [ m ] - serving washington state from seattle ( only calibrating displays they sell ) .
max delo at definitive audio - isfccc [ 8g ] [ 9g ] [ m ] - serving washington state from seattle ( only calibrating displays they sell ) .
jon spackman at creative concept sound solutions - isfccc [ 7g ] [ 8g ] [ 9g ] [ m ] - serving southern california from aliso viejo , ca .
anthony lester at clearpoint - isfccc [ 7g ] [ 8g ] [ 9g ] [ m ] - serving greenville south carolina and the surrounding states .
david hancock at hancock technologies - isfccc [ 8g ] [ 9g ] [ m ] - serving western new york including rochester , buffalo & syracuse .
don brooks at accurate video - isfccc [ 8g ] [ 9g ] [ m ] - serving new jersey , pennsylvania , delaware , maryland & dc .
tom werner at the audio artisans - isfccc [ 7g ] [ 8g ] [ 9g ] [ m ] - serving mt , id , nd , sd and wy from bozeman , montana .
jeremy wilson at condrum - isfccc [ 7g ] [ 8g ] [ 9g ] [ m ] - serving illinois from downers grove .
jeff debonis at precision av calibration - isfccc [ 8g ] [ 9g ] [ m ] - serving ohio and western pa from chagrin falls ohio .
ed johnson at ej video calibration llc - isfccc [ 8g ] [ 9g ] [ m ] - serving new york .
sonny difranco at home theatre guru - isfccc [ 8g ] [ 9g ] [ m ] - serving central texas from austin .
andrew pustizzi at signature home theaters - isfccc [ 7g ] [ 8g ] [ 9g ] [ m ] - serving new jersey from vineland .
jeff davis at depth of clarity - isfccc [ 7g ] [ 8g ] [ 9g ] [ m ] - serving calgary and southern alberta canada ( call 403-875-6731 ) .
bill blaylock at austin audio tech - isfccc [ 7g ] [ 8g ] [ 9g ] [ m ] - serving austin texas and surrounding areas .
donald mclaughlin at precision video calibrations - isfccc [ 7g ] [ 8g ] [ 9g ] [ m ] - serving north central and central florida .
lyle corbin at crystal clear home theater - isfccc [ 7g ] [ 8g ] [ 9g ] [ m ] - serving seattle &#8217; s eastside and metropolitan areas .
charles cooper at cinetune av - isfccc [ 7g ] [ 8g ] [ 9g ] [ m ] - serving georgia from norcross .
glen watase at wds av interiors - isfccc [ 7g ] [ 8g ] [ 9g ] [ m ] - serving hawaii .
cooper stofer at lava - isfccc [ 7g ] [ 8g ] [ 9g ] [ m ] - serving the greater lexington ky area .
john bartolotta at jb home theatre calibrations - isfccc [ 7g ] [ 8g ] [ 9g ] [ m ] - serving long island & new york city vicinity .
greg erianne at all high def - isfccc [ 7g ] [ 8g ] [ 9g ] [ m ] - serving the entire state of connecticut ; based in watertown , ct ( call 203-206-9116 ) .
james yun at hts ( hippo tech solutions ) - isfccc [ m ] - serving the san francisco bay area .
do not calibrate the 9g non-elites , but these professionals do calibrate the elites : jeff meier at accucal - isfccc [ 8g ] [ 9g ] [ m ] - national tours ( al , ar , az , ca , co , ct , de , fl , ga , hi , ia , il , in , ks , la , ma , md , me , mo , ms , nc , nj , nv , nh , ny , ok , oh , pn , ri , sc , tn , tx , va , wi , wv ) .
craig heim at simplehome - isfccc [ 8g ] [ 9g ] - full service integrator serving new england ( westborough , massachusetts based with satellite office in stowe , vt ) .
pete nelsen at attuned audio & video services - isfccc [ 8g ] [ 9g ] - serving broad brook , connecticut .
also , d - nice does calibrations .
d - nice - isfccc [ 7g ] [ 8g ] [ 9g ] [ m ] - serving all of south carolina , north carolina and georgia , columbia south carolina based .
edit : read kevin miller 's " pioneer pdp - 6020fd calibration " blog post .
owner 's professional post calibration reports and reviews .
